立法院第8屆第5會期經濟、財政、內政三委員會第2次聯席會議議事錄

時　　間：103年4月28日（星期一）上午9時6分至下午5時31分

	地　　點：本院紅樓101會議室

						出席委員：黃昭順	費鴻泰	邱文彥	賴士葆	徐耀昌	周倪安	林岱樺	蘇震清	葉津鈴	陳明文	李俊俋	廖國棟	許添財	王惠美	楊瓊瓔	吳秉叡	陳超明	黃偉哲	李慶華	羅明才	邱議瑩	李應元	薛  凌	陳其邁	段宜康	姚文智	盧秀燕	丁守中	陳怡潔	紀國棟	林德福	鄭天財	潘孟安	吳育昇	孫大千	盧嘉辰	張慶忠	

		委員出席37人

						請假委員：張嘉郡

						列席委員：李貴敏	陳歐珀	江啟臣	楊麗環	蕭美琴	林佳龍	李桐豪	蔡煌瑯	簡東明	吳育仁	李昆澤	廖正井	羅淑蕾	楊應雄  陳節如	江惠貞	呂學樟	葉宜津	蔣乃辛	管碧玲	孔文吉	邱志偉	蘇清泉	劉建國	許智傑  蔡其昌  趙天麟	呂玉玲	陳亭妃	鄭麗君	何欣純  王進士	高金素梅	陳唐山	田秋堇	高志鵬	林淑芬	尤美女	魏明谷	柯建銘	吳宜臻	徐欣瑩  潘維剛	楊  曜  劉櫂豪  王廷升	曾巨威	顏寬恒

		委員列席48人

	列席人員：國家發展委員會主任委員	管中閔

	法制協調中心主任		張惠娟

	產業發展處處長	詹方冠

	國土區域離島發展處簡任技正	陳荔芬

	經濟發展處簡任視察		杜美勳

	經濟部常務次長		沈榮津

	商業司副司長		陳秘順

	投資審議委員會代理執行秘書	張銘斌

	工業局局長		吳明機

	組長		蕭振榮

	加工出口區管理處處長		黃文谷

	專門委員		張秀貞

	國際貿易局副組長		鄭香芽

	內政部營建署副署長		許文龍

		地政司專門委員			施明賜(上午)

	入出國及移民署專門委員		曹顧齡

	財政部常務次長		許虞哲

	賦稅署署長		吳自心

	關務署副署長		周順然

	國庫署副署長		蕭家旗

	國有財產署副署長		李政宗

	教育部高等教育司副司長		馬湘萍

	衛生福利部醫事司司長		李偉強

	外交部國際合作及經濟事務司科長	王怡萱(上午)

		專員	魏月涵(下午)

	勞動部綜合規劃司副司長		莊美娟

	    勞動力發展署副組長		趙文徽

	交通部航政司簡任技正		盧清泉

	科技部常務次長		陳德新

	      產學及園區業務司專門委員	黃郁禎

	    新竹科學工業園區管理局工商組組長	陳淑珠

	行政院農業委員會副主任委員	胡興華(上午)

	企劃處處長		曹紹徽

	國際處副處長	蕭柊瓊(上午)

	處長		許桂森(下午)

	法規委員會執行秘書	張學文

	    林務局局長		李桃生

	    動植物防疫檢疫局局長		張淑賢

	    水土保持局局長		黃明耀

	    漁業署主任秘書		黃鴻燕

	行政院大陸委員會經濟處處長	李麗珍

	金融監督管理委員會綜合規劃處副處長	林志吉

	行政院環境保護署綜合計畫處專門委員	洪淑幸

	行政院主計總處公務預算處研究委員	黃耀生

	法務部法制司參事		羅建勛

主　　席：黃召集委員昭順

專門委員：黃素惠

主任秘書：李水足

	紀　　錄：簡任秘書 葉義生  	簡任編審 黃殿偉

	科    長 朱莉華  	專    員 楊雅如

速　　記：公報處記錄人員

報  告  事  項

宣讀上次會議議事錄。

決定：議事錄確定。

討  論  事  項

		繼續審查行政院函請審議「自由經濟示範區特別條例草案」案。(逐條審查)

決議： 

一、法案名稱、第一章章名、第一條至第三條條文，均照案通過。

二、第四條以下條文，另擇期繼續審查。

	散會

1





1