立法院第8屆第5會期第1次臨時會經濟、財政、內政三委員會第1次聯席會議議事錄

時　　間：103年6月26日（星期四）上午9時3分至12時9分

	地　　點：紅樓101會議室

						出席委員：丁守中	蘇震清	葉津鈴	邱文彥	陳明文	黃昭順
賴振昌	紀國棟	周倪安	王惠美	陳其邁	吳秉叡
廖國棟	段宜康	鄭天財	李俊俋	費鴻泰	李應元
薛  凌	林岱樺	盧嘉辰	林德福	許添財	黃偉哲
盧秀燕	陳怡潔	孫大千	吳育昇	羅明才	張慶忠
徐耀昌	蔡正元	陳超明	李慶華	邱議瑩
委員出席35人

					請假委員：張嘉郡	楊瓊瓔

						列席委員：陳歐珀	蔡其昌	尤美女	李桐豪	蕭美琴	葉宜津
林鴻池	陳節如	蔡煌瑯	管碧玲	李昆澤	柯建銘
鄭麗君	田秋堇	何欣純	林淑芬	劉建國	趙天麟
許智傑	楊  曜	陳亭妃
委員列席21人

	列席人員：國家發展委員會主任委員	管中閔

	法制協調中心主任	張惠娟

	副主任	劉美琇

	產業發展處處長	詹方冠

	經濟部部長		張家祝

	常務次長		沈榮津

	商業司副司長		陳秘順

	工業局主任秘書		游振偉

	組長		蕭振榮

	科長		陳建堂

	投資審議委員會組長		朱  萍

	加工出口區管理處主任秘書		楊伯耕

	科長		梁麗琴

	國際貿易局副組長		朱財立

	內政部營建署副署長		許文龍

	地政司簡任技正		王成機

	入出國及移民署專門委員		曹顧齡

	移民事務組科長	黃英貴

	財政部常務次長		許虞哲

	賦稅署副署長		許慈美

	關務署副署長		周順然

	國庫署副署長		蕭家旗

	簡任稽核		張意欣

	國有財產署副署長		李政宗

	教育部高等教育司專門委員		朱俊彰

	衛生福利部常務次長		許銘能

	醫事司副司長		王宗曦

	外交部國際合作及經濟事務司專員	魏月涵

	領務局簽證組國際事務科科長	周  文

	勞動部綜合規劃司科長		易永嘉

	勞動力發展署副組長		趙文徽

	職業安全衛生署技正		李柏宏

	交通部航政司簡任技正		鄭鴻政

	科技部產學及園區業務司司長	邱求慧

	科員	謝祐湘

	新竹科學工業園區管理局科長	李秀春

	行政院農業委員會副主任委員	胡興華

	企劃處處長		曹紹徽

	國際處副處長	蕭柊瓊

	法規委員會執行秘書	張學文

	屏東農業生物技術園區籌備處組長	楊聰敏

	行政院大陸委員會經濟處專門委員	李佩儒

	金融監督管理委員會綜合規劃處副處長	林志吉

	副研究員	黃寶玉

	證券期貨局專門委員		呂弦音

	銀行局專門委員		施宜君

	行政院環境保護署綜合計畫處簡任視察	吳鈴筑

	行政院主計總處公務預算處研究委員	黃耀生

	法務部法制司參事		羅建勛

	檢察司科長		李貞慧

	國際及兩岸法律司科長		王治宇

主　　席：黃召集委員昭順

專門委員：黃素惠

主任秘書：李水足

	紀　　錄：簡任秘書 葉義生  	簡任編審 黃殿偉

	科    長 朱莉華  	專    員 楊雅如

速　　記：公報處記錄人員

報  告  事  項

宣讀立法院第8屆第5會期經濟、財政、內政三委員會第6次聯席會議議事錄。

決定：議事錄確定。

討  論  事  項

		繼續審查行政院函請審議「自由經濟示範區特別條例草案」案。(逐條審查)

決議：第四條條文，委員發言至葉津鈴委員，其餘登記發言之委員下次會議繼續發言。

	散會

3





1