立法院第8屆第5會期經濟、財政、內政三委員會第1次聯席會議議事錄

時　　間：103年3月6日（星期四）上午9時7分至12時22分、下午2時29分至5時45分

	地　　點：本院紅樓101會議室

出席委員：林滄敏  林岱樺  丁守中  廖國棟  陳明文  許添財  林德福  賴士葆  賴振昌  李應元  吳育昇  李慶華  吳秉叡  盧秀燕  費鴻泰  段宜康  周倪安  紀國棟  楊瓊瓔  王惠美  黃偉哲  孫大千  邱文彥  黃昭順  葉津鈴  蘇震清  鄭天財  翁重鈞  李俊俋  薛  凌  陳其邁  邱議瑩  徐耀昌  陳怡潔  張慶忠  陳超明  盧嘉辰  潘孟安  羅明才  張嘉郡  蔡正元  姚文智  

		委員出席42人

	列席委員：許智傑  陳亭妃  陳歐珀  江啟臣  廖正井  柯建銘  林佳龍  蔡其昌  李昆澤  葉宜津  李桐豪  楊應雄  蔡煌瑯  林國正  吳育仁  孔文吉  蔡錦隆  羅淑蕾  楊麗環  管碧玲  蕭美琴  陳淑慧  何欣純  陳節如  蔣乃辛  簡東明  邱志偉  高金素梅  蘇清泉  鄭麗君  陳唐山  高志鵬  田秋堇  尤美女  林明溱  林淑芬  鄭汝芬  魏明谷  徐欣瑩  呂玉玲  劉建國  吳宜臻  黃志雄  陳碧涵  趙天麟  劉櫂豪

		委員列席46人

	列席人員：國家發展委員會主任委員	管中閔

	副主任委員		陳建良

	產業發展處處長	詹方冠

	法制協調中心主任		張惠娟

	經濟部部長		張家祝

	商業司司長		游瑞德(上午)

	      副司長		陳秘順(下午)

	法規委員會執行秘書		鄭國榮

	工業局局長		吳明機

	加工出口區管理處處長		黃文谷

	國際貿易局組長		陳敬智

	投資審議委員會代執行秘書		張銘斌

	內政部政務次長		蕭家淇

		地政司副司長			王靚琇

	營建署副署長		許文龍

	入出國及移民署署長		謝立功(上午)

	              副署長		張  琪(下午)

	財政部部長		張盛和

	賦稅署署長		吳自心

	關務署署長		饒  平

	國有財產署署長		莊翠雲

	教育部高等教育司司長		黃雯玲(上午)

	                副司長		馬湘萍(下午)

	                專門委員		朱俊彰

	衛生福利部醫事司司長		李偉強

	外交部國際合作及經濟事務司司長	賴建中

	    領事事務局簽證組科長		周  文

	勞動部政務次長		郝鳳鳴

	      綜合規劃司專門委員		林永裕

	                科長		易永嘉

	    勞動力發展署副組長		趙文徽

	    職業安全衛生署科長		劉約瑟

	交通部航政司副司長		陳進生

	    航港局副局長		李雲萬

	科技部政務次長		林一平(上午)

	      常務次長		陳德新(下午)

	      產學及園區業務司專門委員	黃郁禎

	    新竹科學工業園區管理局工商組組長	陳淑珠

	行政院農業委員會主任委員		陳保基

	                企劃處代理處長	曹紹徽

	                國際處處長	許桂森

	    林務局副局長		楊宏志

	    水土保持局副局長		李鎮洋

	    漁業署主任秘書		黃鴻燕

	    屏東農業生物技術園區籌備處主任	黃金城

	行政院大陸委員會經濟處處長	李麗珍

	金融監督管理委員會副主任委員	黃天牧

	                  綜合規劃處處長	蘇郁卿

	    證券期貨局副局長		張麗真

	    保險局副組長		江玉卿

	    銀行局副組長		黃錫和

	行政院環境保護署環境衛生及毒物管理處簡任技正	張文興

	                綜合計畫處簡任技正	尤泳智

	行政院主計總處公務預算處簡任視察	曾煥棟

	法務部法制司副司長		林嚞慧

主　　席：黃召集委員昭順

專門委員：黃素惠

主任秘書：李水足

	紀　　錄：簡任秘書 葉義生  	簡任編審 黃殿偉

	科    長 朱莉華  	專    員 楊雅如

速　　記：公報處記錄人員

討  論  事  項

		審查行政院函請審議「自由經濟示範區特別條例草案」案。

（國家發展委員會管主任委員、經濟部張部長就「自由經濟示範區特別條例草案」報告後，委員林滄敏、林岱樺、丁守中、李慶華、陳明文、許添財、林德福、潘孟安、葉津鈴、吳育昇、徐耀昌、翁重鈞、周倪安、蘇震清、李應元、王惠美、陳怡潔、黃昭順、賴振昌、李桐豪及尤美女等21人提出質詢，均由國家發展委員會管主任委員、經濟部張部長、財政部張部長、行政院農業委員會陳主任委員、教育部高等教育司馬副司長暨相關人員即席答復。委員楊瓊瓔、潘維剛、張嘉郡、黃偉哲、鄭汝芬、李昆澤所提書面質詢，列入紀錄，刊登公報，請相關主管機關以書面答復，並副知本委員會。委員口頭質詢未及答復部分，請相關主管機關於1週內以書面答復，並副知本委員會。委員口頭質詢中要求提供之相關資料，亦請於1週內送交本委員會，並分送相關委員。）

決議：報告及詢答完畢，另擇期繼續審查。

通過決議1案：

一、針對自由經濟示範區之推動規劃內容，一般民眾不清楚規劃的內容及產生之影響，包括造成不公平競爭及歧視、對台灣農業、勞工、環保、醫療、教育等造成衝擊，以及對於未列入示範區之縣市產生資源排擠等情事，然而，政府並沒有事先與相關利害團體或產業充分溝通，更沒有提出完整的評估報告。其中，管制中的830項中國農產品原料可以開放進入自經區，以及未管制的中國農產品也會因零關稅而增加進入台灣的數量，還有經加工後可以掛上MIT品牌外銷，將會取代既有出口的台灣食品加工品，對於本地直接耕作的農民生計恐產生重大衝擊。爰要求經濟、財政、內政三委員會聯席會議審查行政院函請審議「自由經濟示範區特別條例草案」，於本聯席審查會進行本草案之逐條審查前，針對本草案中有關：1.農業加值及得輸入現行禁止進口之中國農產品，對於我國農業部門暨農產加工及食品加工產業之衝擊評估，及准許輸入保育類野生動物活體之必要性。2.土地便捷所涉相關條文及本條例所定相關徵收等規定之必要性及其對憲法保障私有財產權之衝擊。3.自由經濟示範區之社會影響評估(含「就業影響評估」及「社會重分配影響評估」)，及對各該關聯產業之影響評估分析，以及租稅措施之必要性及其稅式支出評估。4.開放設立國際醫療機構，對於我國醫療體制及健保體系之衝擊評估。5.智慧物流、教育服務業、專業服務業之衝擊評估等議題，應召開5場次之公聽會，公聽會由黃昭順委員主持3場，林岱樺委員主持2場，並於103年3月31日前完成公聽會，聽取社會各界意見，方得進行逐條審查，以廣納民意並善盡國會監督之責。

提案人：黃昭順  翁重鈞  楊瓊瓔  黃偉哲  潘孟安  陳明文  邱議瑩  蘇震清  林滄敏  林岱樺  吳秉叡  李應元  賴振昌  葉津鈴  周倪安  廖國棟  柯建銘  高志鵬  管碧玲  

	散會

1





1