立法院第8屆第5會期經濟、財政、內政三委員會第6次聯席會議議事錄

時　　間：103年5月29日（星期四）下午2時49分至5時36分

	地　　點：紅樓101會議室

						出席委員：林德福	吳育昇	潘孟安	周倪安	陳怡潔	吳秉叡
蘇震清	賴振昌	段宜康	李應元	李俊俋	陳明文
黃昭順	黃偉哲	薛  凌	林岱樺	邱議瑩	葉津鈴
王惠美	林滄敏	孫大千	鄭天財	陳超明	許添財
翁重鈞	費鴻泰	張嘉郡	盧秀燕	李慶華	羅明才
姚文智	廖國棟	丁守中	楊瓊瓔	邱文彥	紀國棟
陳其邁	張慶忠	蔡正元	
委員出席39人

						列席委員：尤美女	王廷升	陳碧涵	鄭麗君

		委員列席4人

	列席人員：國家發展委員會主任委員	管中閔

	法制協調中心主任		張惠娟

	副主任		劉美琇

	經濟部常務次長		沈榮津

	商業司副參事		周國欽

	工業局副局長		連錦漳

	科長		盧碧黛

	國際貿易局副組長		朱財立

	投資審議委員會組長		朱  萍

	加工出口區管理處副處長		趙建民

	專門委員		張秀貞

	內政部地政司專門委員		施明賜

	營建署簡任技正		張順勝

	入出國及移民署專門委員		曹顧齡

	移民事務組科長	黃英貴

	財政部政務次長		吳當傑

	賦稅署副署長		蔡碧珍

	關務署副署長		周順然

	國有財產署副署長		李政宗

	國庫署組長		顏春蘭

	教育部高等教育司專門委員		朱俊彰

	衛生福利部政務次長		林奏延

	醫事司司長		李偉強

	外交部國際合作及經濟事務司貿易投資科專員	魏月涵

	勞動部綜合規劃司副司長		莊美娟

	科長		易永嘉

	勞動力發展署副組長		趙文徽

	職業安全衛生署技士		翁啟修

	交通部航政司簡任技正		盧清泉

	航港局簡任技正		王大明

	民用航空局技正		游政霖

	臺灣港務股份有限公司副處長	張紋英

	科技部產學及園區業務司司長	邱求慧

	科員	謝祐湘

	    新竹科學工業園區管理局工商組組長	陳淑珠

	行政院農業委員會副主任委員	王政騰

	國際處處長		許桂森

	企劃處副處長	陳耀勳

	行政院大陸委員會經濟處專門委員	李佩儒

	科長	林國隆

	金融監督管理委員會綜合規劃處副處長	林志吉

	副研究員	黃寶玉

	銀行局助理研究員		陳奕甫

	證券期貨局副研究員		許心婷

	行政院環境保護署綜合計畫處專門委員	洪淑幸

	行政院主計總處公務預算處專門委員	李錫東

	法務部法制司參事		羅建勛

主　　席：黃召集委員昭順

專門委員：黃素惠

主任秘書：李水足

	紀　　錄：簡任秘書 葉義生  	簡任編審 黃殿偉

	科    長 朱莉華  	專    員 楊雅如

速　　記：公報處記錄人員

報  告  事  項

宣讀上次會議議事錄。

決定：第4次、第5次聯席會議議事錄均確定。

討  論  事  項

		繼續審查行政院函請審議「自由經濟示範區特別條例草案」案。(逐條審查)

決議： 

第二條條文，行政院提案及委員吳秉叡等人、委員林岱樺等人、委員賴振昌等人所提修正動議，均保留。

第三條條文，委員發言完畢，行政院提案及委員吳秉叡等人、委員黃偉哲等人、委員葉津鈴等人、委員賴振昌等人、委員陳其邁等人、委員李俊俋等人所提修正動議，均保留。

	散會

1





1